██████████████████████████████████████████████████████████████
██                  ██      ██  ██  ██                      ██
██  ██████  ██  ██████  ██  ██  ██  ██████████████  ██  ██  ██
██      ██  ██      ██  ██      ██                  ██  ██  ██
██  ██████  ██████████████████  ██████  ██████  ██  ██████  ██
██      ██                  ██          ██      ██  ██      ██
██  ██████  ██████████  ██████  ██  ██████████  ██  ██  ██████
    ██  ██  ██          ██      ██      ██  ██  ██  ██      ██
██████  ██████  ██████  ██  ██  ██████  ██  ██████████████  ██
██                  ██  ██  ██      ██                  ██  ██
██████████████  ██████████  ██████████████  ██████████  ██████
██      ██      ██              ██      ██  ██          ██  ██
██  ██████  ██████████  ██████████████  ██████  ██  ██  ██  ██
██          ██                      ██      ██  ██  ██  ██  ██
██  ██  ██  ██  ██████████  ██  ██████  ██████████  ██████  ██
██  ██  ██          ██      ██      ██                  ██  ██
██████████  ██████████  ██████████████  ██████  ██████  ██  ██
██      ██  ██      ██  ██          ██  ██          ██  ██  ██
██████  ██  ██  ██████████  ██  ██  ██  ██  ██  ██████████  ██
██      ██              ██  ██  ██      ██  ██      ██      ██
██  ██  ██  ██████████  ██████  ██████████████████  ██████  ██
██  ██          ██          ██              ██              ██
██  ██████████  ██  ██████████  ██████████  ██████  ██  ██  ██
██      ██      ██      ██  ██          ██      ██  ██  ██  ██
██████  ██████  ██████████  ██████  ██████████████████  ██████
██          ██          ██      ██      ██                  ██
██  ██████████  ██████████  ██████  ██████████████  ██████████
██      ██      ██              ██  ██  ██              ██  ██
██  ██  ██████  ██  ██████  ██████  ██  ██  ██  ██████  ██  ██
██  ██  ██              ██  ██      ██      ██  ██
██████████████████████████████████████████████████████████████
